
{
  "maps": [
    {
      "id": 1,
      "layout": [
        "____________________________",
        "____________________________",
        "______||||||||||||||||______",
        "______|.o..........o.|______",
        "______|.||.||||||.||.|______",
        "______|.||.||||||.||.|______",
        "______|.||...||...||.|______",
        "______|.||||.||.||||.|______",
        "|||||||.||||.||.||||.|||||||",
        "........||........||........",
        "|||.||||||.||||||.||||||.|||",
        "|||.||||||.||||||.||||||.|||",
        "|.......||...||...||.......|",
        "|.|||||.||||.||.||||.|||||.|",
        "|.|||||.||||.||.||||.|||||.|",
        "|....||..............||....|",
        "||||.||||.|||==|||.||||.||||",
        "||||.||||.|______|.||||.||||",
        "..||......|______|......||..",
        "|.||.||||.|______|.||||.||.|",
        "|....||||.||||||||.||||....|",
        "|.||.||..............||.||.|",
        "|.||.||.||||||||||||.||.||.|",
        "|.||.||.||||||||||||.||.||.|",
        "..||.||......||......||.||..",
        "||||.|||||||.||.|||||||.||||",
        "||||.|||||||.||.|||||||.||||",
        "|............  ............|",
        "|.||.||||||||||||||||||.||.|",
        "|.||.|________________|.||.|",
        "|o||.|________________|.||o|",
        "|.||.|________________|.||.|",
        "|....|________________|....|",
        "||||||________________||||||",
        "____________________________",
        "____________________________"
      ]
    },
    {
      "id": 2,
      "layout": [
        "____________________________",
        "____________________________",
        "____________________________",
        "||||||||||||||||||||||||||||",
        "|............||............|",
        "|.||||.|||||.||.|||||.||||.|",
        "|o|__|.|___|.||.|___|.|__|o|",
        "|.||||.|||||.||.|||||.||||.|",
        "|..........................|",
        "|.||||.||.||||||||.||.||||.|",
        "|.||||.||.||||||||.||.||||.|",
        "|......||....||....||......|",
        "||||||.|||||.||.|||||.||||||",
        "_____|.|||||.||.|||||.|_____",
        "_____|.||..........||.|_____",
        "_____|.||.|||==|||.||.|_____",
        "||||||.||.|______|.||.||||||",
        "..........|______|..........",
        "||||||.||.|______|.||.||||||",
        "_____|.||.||||||||.||.|_____",
        "_____|.||..........||.|_____",
        "_____|.||.||||||||.||.|_____",
        "||||||.||.||||||||.||.||||||",
        "|............||............|",
        "|.||||.|||||.||.|||||.||||.|",
        "|.||||.|||||.||.|||||.||||.|",
        "|o..||.......  .......||..o|",
        "|||.||.||.||||||||.||.||.|||",
        "|||.||.||.||||||||.||.||.|||",
        "|......||....||....||......|",
        "|.||||||||||.||.||||||||||.|",
        "|.||||||||||.||.||||||||||.|",
        "|..........................|",
        "||||||||||||||||||||||||||||",
        "____________________________",
        "____________________________"
      ]
    },
    { "id": 3,
      "layout": [
        "____________________________",
        "____________________________",
        "____________________________",
        "||||||||||||||||||||||||||||",
        "|......||..........||......|",
        "|o||||.||.||||||||.||.||||o|",
        "|.||||.||.||||||||.||.||||.|",
        "|..........................|",
        "|||.||.|||||.||.|||||.||.|||",
        "__|.||.|___|.||.|___|.||.|__",
        "|||.||.|||||.||.|||||.||.|||",
        "....||.......||.......||....",
        "|||.|||||.||||||||.|||||.|||",
        "__|.|||||.||||||||.|||||.|__",
        "__|......................|__",
        "__|.|||||.|||==|||.|||||.|__",
        "__|.|||||.|______|.|||||.|__",
        "__|.||....|______|....||.|__",
        "__|.||.||.|______|.||.||.|__",
        "|||.||.||.||||||||.||.||.|||",
        ".......||..........||.......",
        "|||.||||||||.||.||||||||.|||",
        "__|.||||||||.||.||||||||.|__",
        "__|..........||..........|__",
        "__|.|||||.||||||||.|||||.|__",
        "|||.|||||.||||||||.|||||.|||",
        "|............  ............|",
        "|.||||.|||||.||.|||||.||||.|",
        "|.|__|.|||||.||.|||||.|__|.|",
        "|.|__|.||....||....||.|__|.|",
        "|o|__|.||.||||||||.||.|__|o|",
        "|.||||.||.||||||||.||.||||.|",
        "|..........................|",
        "||||||||||||||||||||||||||||",
        "____________________________",
        "____________________________"
        ]},
    { "id": 4,
      "layout": [
        "____________________________",
        "____________________________",
        "____________________________",
        "||||||||||||||||||||||||||||",
        "|.........||....||.........|",
        "|o|||||||.||.||.||.|||||||o|",
        "|.|||||||.||.||.||.|||||||.|",
        "|.||.........||.........||.|",
        "|.||.||.||||.||.||||.||.||.|",
        "|....||.||||.||.||||.||....|",
        "||||.||.||||.||.||||.||.||||",
        "||||.||..............||.||||",
        " ....||||.||||||||.||||.... ",
        "|.||.||||.||||||||.||||.||.|",
        "|.||....................||.|",
        "|.||||.||.|||==|||.||.||||.|",
        "|.||||.||.|______|.||.||||.|",
        "|......||.|______|.||......|",
        "|.||.||||.|______|.||||.||.|",
        "|.||.||||.||||||||.||||.||.|",
        "|.||....................||.|",
        "|.||||.|||||.||.|||||.||||.|",
        "|.||||.|||||.||.|||||.||||.|",
        "|......||....||....||......|",
        "|||.||.||.||||||||.||.||.|||",
        "|||.||.||.||||||||.||.||.|||",
        "|o..||.......  .......||..o|",
        "|.||||.|||||.||.|||||.||||.|",
        "|.||||.|||||.||.|||||.||||.|",
        "|......||....||....||......|",
        "|.||||.||.||||||||.||.||||.|",
        "|.||||.||.||||||||.||.||||.|",
        "|......||..........||......|",
        "||||||||||||||||||||||||||||",
        "____________________________",
        "____________________________"
        ]},
    { "id": 5,
      "layout": [
        "____________________________",
        "____________________________",
        "____________________________",
        "||||||||||||||||||||||||||||",
        "|..........................|",
        "|.||.||||.||||||||.||||.||.|",
        "|o||.||||.||||||||.||||.||o|",
        "|.||.||||.||....||.||||.||.|",
        "|.||......||.||.||......||.|",
        "|.||||.||.||.||.||.||.||||.|",
        "|.||||.||.||.||.||.||.||||.|",
        "|......||....||....||......|",
        "|||.||||||||.||.||||||||.|||",
        "__|.||||||||.||.||||||||.|__",
        "__|....||..........||....|__",
        "||| ||.||.|||==|||.||.|| |||",
        "    ||.||.|______|.||.||    ",
        "||||||....|______|....||||||",
        "||||||.||.|______|.||.||||||",
        "....||.||.||||||||.||.||....",
        "|||.||.||..........||.||.|||",
        "__|....|||||.||.|||||....|__",
        "__|.||.|||||.||.|||||.||.|__",
        "__|.||.......||.......||.|__",
        "__|.|||||.||.||.||.|||||.|__",
        "|||.|||||.||.||.||.|||||.|||",
        "|.........||.  .||.........|",
        "|.||||.||.||||||||.||.||||.|",
        "|.||||.||.||||||||.||.||||.|",
        "|.||...||..........||...||.|",
        "|o||.|||||||.||.|||||||.||o|",
        "|.||.|||||||.||.|||||||.||.|",
        "|............||............|",
        "||||||||||||||||||||||||||||",
        "____________________________",
        "____________________________"
        ]},
    { "id": 6,
      "layout": [
        "____________________________",
        "____________________________",
        "____________________________",
        "||||||||||||||||||||||||||||",
        ".....||..............||.....",
        "||||.||.||||||||||||.||.||||",
        "___|.||.||||||||||||.||.|___",
        "___|o...||........||...o|___",
        "___|.||.||.||||||.||.||.|___",
        "||||.||....|____|....||.||||",
        ".....||.||.||||||.||.||.....",
        "|.||.||.||........||.||.||.|",
        "|.||.||.||||||||||||.||.||.|",
        "|.||.||.||||||||||||.||.||.|",
        "|..........................|",
        "|.|||||||.|||==|||.|||||||.|",
        "|.|||||||.|______|.|||||||.|",
        "|.||......|______|......||.|",
        "|.||.||||.|______|.||||.||.|",
        "|....||||.||||||||.||||....|",
        "|||||||..............|||||||",
        "|||||||.||||||||||||.|||||||",
        "|.......||||||||||||.......|",
        "|.|||.||||........||||.|||.|",
        "|.|||.||||.||||||.||||.|||.|",
        "|.......||.||||||.||.......|",
        "|||||||.||...  ...||.|||||||",
        "|||||||.||.||||||.||.|||||||",
        "|....||.||.||||||.||.||....|",
        "|o||.||.||........||.||.||o|",
        "|.||....||.||||||.||....||.|",
        "|.||.||.||.||||||.||.||.||.|",
        "|....||..............||....|",
        "||||||||||||||||||||||||||||",
        "____________________________",
        "____________________________"
        ]},
    { "id": 7,
      "layout": [
        "____________________________",
        "____________________________",
        "____________________________",
        "||||||||||||||||||||||||||||",
        "|....||..............||....|",
        "|.||.||.||||||||||||.||.||.|",
        "|o||.||.||||||||||||.||.||o|",
        "|.||......||....||......||.|",
        "|.|||||||.||.||.||.|||||||.|",
        "|.|||||||.||.||.||.|||||||.|",
        "|......||....||....||......|",
        "|||.||.||.||.||.||.||.||.|||",
        "|||.||....||.||.||....||.|||",
        "|...||.||.||.||.||.||.||...|",
        "|.||||.||..........||.||||.|",
        "|.||||.||.|||==|||.||.||||.|",
        "|...||....|______|....||...|",
        "|||.|||||.|______|.|||||.|||",
        "|||.|||||.|______|.|||||.|||",
        "|......||.||||||||.||......|",
        "|.||||.||..........||.||||.|",
        "|.|__|.||.||.||.||.||.|__|.|",
        "|.||||.||.||.||.||.||.||||.|",
        "|.........||.||.||.........|",
        "||||.|||||||.||.|||||||.||||",
        "||||.|||||||.||.|||||||.||||",
        "........||...  ...||........",
        "||||.||.||.||||||.||.||.||||",
        "___|.||.||.||||||.||.||.|___",
        "___|.||.o..........o.||.|___",
        "___|.|||||||.||.|||||||.|___",
        "||||.|||||||.||.|||||||.||||",
        ".............||.............",
        "||||||||||||||||||||||||||||",
        "____________________________",
        "____________________________"
        ]},
    { "id": 8,
      "layout": [
        "____________________________",
        "____________________________",
        "____________________________",
        "||||||||||||||||||||||||||||",
        "|....||......||......||....|",
        "|o||.||.||||.||.||||.||.||o|",
        "|.||.||.||||.||.||||.||.||.|",
        "|.||.||.||........||.||.||.|",
        "|.......||.||||||.||.......|",
        "|.||.|||||.||||||.|||||.||.|",
        "|.||.|||||...||...|||||.||.|",
        "|.||....||||.||.||||....||.|",
        "|.||.||.||||.||.||||.||.||.|",
        "|.||.||..............||.||.|",
        "|.||.||||.|||==|||.||||.||.|",
        "|.||.||||.|------|.||||.||.|",
        "|.........|------|.........|",
        "|.||.||||.|------|.||||.||.|",
        "|.||.||||.||||||||.||||.||.|",
        "|.||....................||.|",
        "|.||||.||||.||||.||||.||||.|",
        "|.||||.||||.||||.||||.||||.|",
        "|........||......||........|",
        "|||.||||.||.||||.||.||||.|||",
        "|||.||||.||.||||.||.||||.|||",
        "|||.||||.||.||||.||.||||.|||",
        "|.....||.....  .....||.....|",
        "|.|||.|||||.||||.|||||.|||.|",
        "|.|||.|||||.||||.|||||.|||.|",
        "|..........................|",
        "|.|||||||||.||||.|||||||||.|",
        "|o|||||||||.||||.|||||||||o|",
        "|..........................|",
        "||||||||||||||||||||||||||||",
        "____________________________",
        "____________________________"
        ]},
    { "id": 9,
      "layout": [
        "____________________________",
        "____________________________",
        "____________________________",
        "||||||||||||||||||||||||||||",
        "|..........................|",
        "|.||||.||||||||||||||.||||.|",
        "|.||||.||||||||||||||.||||.|",
        "|...||.......||.......||...|",
        "|||.|||||.||.||.||.|||||.|||",
        "|||.|||||.||.||.||.|||||.|||",
        "|||.|||||.||.||.||.|||||.|||",
        "|.........||....||.........|",
        "|.|||.|||.||||||||.|||.|||.|",
        "|.|||.|||.||||||||.|||.|||.|",
        "|..........................|",
        "|||||.|||.|||==|||.|||.|||||",
        "|||||.|||.|------|.|||.|||||",
        "||........|------|........||",
        "||.||.|||.|------|.|||.||.||",
        "||.||.|||.||||||||.|||.||.||",
        "||.||..................||.||",
        "||.||||||.||||||||.||||||.||",
        "||.||||||.||||||||.||||||.||",
        "||........................||",
        "||.||||||.||||||||.||||||.||",
        "||.||||||.||||||||.||||||.||",
        "||...||......  ......||...||",
        "||||.||.||||.||.||||.||.||||",
        "||||.||.||||.||.||||.||.||||",
        "|.......||...||...||.......|",
        "|.||||||||.||||||.||||||||.|",
        "|.||||||||.||||||.||||||||.|",
        "|..........................|",
        "||||||||||||||||||||||||||||",
        "____________________________",
        "____________________________"
        ]},
    {
      "id": 10,
      "layout": [
        "____________________________",
        "____________________________",
        "____________________________",
        "||||||||||||||||||||||||||||",
        "|..........................|",
        "|.|||.|||.||||||||.|||.|||.|",
        "|.|||.|||.||||||||.|||.|||.|",
        "|..........................|",
        "|.|||||.||||||||||||.|||||.|",
        "|.|||||.||||||||||||.|||||.|",
        "|....||..............||....|",
        "|.||.||||.||.||.||.||||.||.|",
        "|.||.||||.||.||.||.||||.||.|",
        "|.||...||.||.||.||.||...||.|",
        "|.||||.||..........||.||||.|",
        "|.||||.||.|||==|||.||.||||.|",
        "|.........|------|.........|",
        "|.||.||||.|------|.||||.||.|",
        "|.||.||||.|------|.||||.||.|",
        "|.||...||.||||||||.||...||.|",
        "|.||||.||..........||.||||.|",
        "|.||||.||.||.||.||.||.||||.|",
        "|......||.||.||.||.||......|",
        "|.||||.||.||.||.||.||.||||.|",
        "|.||||....||.||.||....||||.|",
        "|...|||||.||.||.||.|||||...|",
        "|||.|||||.||.  .||.|||||.|||",
        "|||.||....||||||||....||.|||",
        "|...||.||.||||||||.||.||...|",
        "|.||||.||....||....||.||||.|",
        "|.||||.||.||.||.||.||.||||.|",
        "|.........||.||.||.........|",
        "||||||||||||....||||||||||||",
        "||||||||||||||||||||||||||||",
        "____________________________",
        "____________________________"
      ]
    }
  ]
}